NO ./textures/imgs/blue_wall.xpm
SO ./textures/imgs/brick_wall_dark.xpm
WE ./textures/imgs/eye_wall.xpm
EA ./textures/imgs/wooden_wall_dark.xpm

F 224,245,66
C 66,245,206


    1
   111
   101
11110111
11N000011
11110111
   101
   111
   111
    1
   111
    1
         1111
         1011
 111     1111
 11111111111
 11111111111