NO ./textures/imgs/blue_wall.xpm
SO ./textures/imgs/brick_wall_dark.xpm
WE ./textures/imgs/eye_wall.xpm
EA ./textures/imgs/wooden_wall_dark.xpm

F 224,245,66
C 66,245,206


           1
          111
         11011
        1100011
       1100G0011
      11001010011
     1100100010011
    110010010010011
   11001001010010011
  1100100100010010011
 110010010000010010011
11001001001N10010010011
 110010010010010010011
  1100100100010010011
   11001001G10010011
    110010000010011
     1100100010011
      11001110011
       110000011
        1100011
         11011
          111
           1