NO ./textures/imgs/blue_wall.xpm
SO ./textures/imgs/brick_wall_dark.xpm
WE ./textures/imgs/eye_wall.xpm
EA ./textures/imgs/wooden_wall_dark.xpm

F 224,245,66
C 66,245,206


11111
10001
10N01
10001
11D11
10001
10001
11111 