NO ./textures/imgs/blue_wall.xpm
SO ./textures/imgs/brick_wall_dark.xpm
WE ./textures/imgs/eye_wall.xpm
EA ./textures/imgs/wooden_wall_dark.xpm

F 224,245,66
C 66,245,206


1111111111111111111111111111111111111111111111111111111111111111111111111111111111111111111111111111111111111111111111111111111111111111111111111111111111111111111111111111111111111111111111111111111111111111111111111
1000000000000000000000000000000000000000000000000000000000000000000000000000000000000000000000000000000000D000D0000000000000000000000000000000000000000000000000000000000000000000000000000000000000000000000000000000001
1111111111111111111111111111111111111111111111111111111111111111111111111111111111111111111111111111111111100011111111111111111111111111111111111111111111111111111111111111111111111111111111111111111111111111111111111
                                                                                                          10001
                                                                                                          10001
                                                                                                          10001
                                                                                                          10001
                                                                                                          10001
                                                                                                          10001
                                                                                  1                       10001              111111111111111111111111111111111111111111111111
                                                                                 1                        10001              111                                           1
                                                                                1                         10001              11                                           1
                                                                               1                          10001              1                                           1
                                                                              1                           10001                                                         1
                                                                             1                            10001                                                        1
                                                                            1                             10001                                                       1
                                                                           1                              10001                                                      1
                                                                          1                               10001                                                     1
                                                                         1                                10001                                                    1
                                                                        1                                 10001                                                   1
                                                                       1                                  10001                                                  1
                                                                      1                                   10001                                                 1
                                                                     1                                    10001                                                1
                                                                    1                                     10001                                               1
                                                                   1                                      10001                                              1
                                                                  1                                       10001                                             1
                                                                 1                                        10001                                            1
                                                                1                                         10001                                           1
                                                               1                                          10001                                          1
                                                              1                                           10001                                         1
                                                             1                                            10001                                        1
                                                            1                                             10001                                       1
                                                           1                                              10001                                      1
                                                          111111111111111111111111111111111               10001                                     1
                                                                                          1               10001                                    1
                                                                                          1               10001                                   1
                                                                                          1               10001                                  1 
                                                                                          1               10001                                 1
                                                                                          1               10001                                1
                                                                                          1               10001                               1
                                                                                          1               10001                              1
                                                                                          1               10001                             1
                                                                                          1               10001                            1
                                                                                          1               10001                           1
                                                                                          1               10001                          1
                                                                                          1               10001                         1
                                                                                          1               10001                        1
                                                                                          1               10001                       1                                    1
                                                                                          1               10001                      1                                    11
                                                                                          1               10001                     1                                    111
                                                                                          1               10001                    11111111111111111111111111111111111111111
                                                                                                          10001
                                                                                                          10001
                                                                                                          10001
                                                                                                          10001
                                                                                                          10001
                                                                                                          10001
                                                                                                          10001
                                                                                                          10001
                                                                                                          10001                                                                                                          
111111111111111111111111111111111111111111111111111111111111111111111111111111111111111111111111111111111111D111111111111111111111111111111111111111111111111111111111111111111111111111111111111111111111111111111111111
1000000000000000000000000000000000000000000000000000000000000000000000000000000000000000000000000000000000D0N0D0000000000000000000000000000000000000000000000000000000000000000000000000000000000000000000000000000000001
111111111111111111111111111111111111111111111111111111111111111111111111111111111111111111111111111111111111D111111111111111111111111111111111111111111111111111111111111111111111111111111111111111111111111111111111111
                                                                                                          10001
                                                                                                          10001
                                                                                                          10001
                                                                                                          10001
                                                                                                          10001
                                                                                                          10001
                                                                                                          10001
                                                                                                          10001
                                                                                                          10001
                                                                                                          10001
                                                                                                          10001
                                                                                                          10001
                                                                                                          10001
                                                                                                          10001
                                                                                                          10001
                                                                                                          10001
                                                                                                          10001
                                                                                                          10001
                                                                                                          10001
                                                                                                          10001
                                                                                                          10001
                                                                                                          10001
                                                                                                          10001
                                                                                                          10001
                                                                                                          10001
                                                                                                          10001
                                                                                                          10001
                                                                                                          10001
                                                                                                          10001
                                                                                                          10001
                                                                                                          10001
                                                                                                          10001
                                                                                                          10001
                                                                                                          10001
                                                                                                          10001
                                                                                                          10001
                                                                                                          10001
                                                                                                          10001
                                                                                                          10001
                                                                                                          10001
                                                                                                          10001
                                                                                                          10001
                                                                                                          10001
                                                                                                          10001
                                                                                                          10001
                                                                                                          10001
                                                                                                          10001
                                                                                                          10001
                                                                                                          10001
                                                                                                          10001
                                                                                                          10001
                                                                                                          10001
                                                                                                          10001
                                                                                                          10001
                                                                                                          10001
                                                                                                          10001
                                                                                                          10001
111111111111111111111111111111111111111111111111111111111111111111111111111111111111111111111111111111111111D111111111111111111111111111111111111111111111111111111111111111111111111111111111111111111111111111111111111
1000000000000000000000000000000000000000000000000000000000000000000000000000000000000000000000000000000000D000D0000000000000000000000000000000000000000000000000000000000000000000000000000000000000000000000000000000001
1111111111111111111111111111111111111111111111111111111111111111111111111111111111111111111111111111111111111111111111111111111111111111111111111111111111111111111111111111111111111111111111111111111111111111111111111