NO ./textures/imgs/blue_wall.xpm
SO ./textures/imgs/brick_wall_dark.xpm
WE ./textures/imgs/eye_wall.xpm
EA ./textures/imgs/wooden_wall_dark.xpm

C 10,50,150
F 50,50,50

           1
          101
         10001
        1001001
       100101001
      10010001001
     1001001001001
    100100101001001
   10010010001001001
  100100101D101001001
 100100100101001001001
  1001001011101001001
   10010010001001001
    1001001D1001001
     1001000001001
      10010001001
       100101001
        1000001
         10001
          101
          101
111111111110111111111111111111
1000000001000000000000000000011
10000011010000000111111100000011
1000000101000000010E0001000000011
10000001010000000D00000100000000011
1000000100000000010000010000000001111
111111111100000001111111000000000011111111111111111111111111111111111111111111111111111
         10000000000000000000000000D00000000000000000000000000000000G000000010000000001
         111000000000000000000000001111111111111111111111111111111111111111000111111111
1111111111110011111111111111111111111                                     11011
1100000000100000000000000011                                               101
1000000000000000000000000001111111111                                      101
10000000010000000000000000000000000G1                                      101
11111111111111D1111111111111D11111111                                      101
             101           101                                             101
             101           101111111111111111111111111111111111111111111111101
             101           100000000000000000000000000000000000000000000000001
             101           1011111111111111011111111111D1111111111111111111111
             101           101   1000000D0101         101
             101           101   101111111101         101
           1110111    111  101   101111111101         101
           1000001    101 1101   100000000001         101
           1000001111111111101111111111111111         1D1
           1001000000000000001                        111
           1000001111111111111
           100G001
           1111111
