NO ./textures/imgs/blue_wall.xpm
SO ./textures/imgs/brick_wall_dark.xpm
WE ./textures/imgs/eye_wall.xpm
EA ./textures/imgs/wooden_wall_dark.xpm

C 068,118,120
F 29,53,87


            11111111111111111
1111111111  10000000000000001                              111
1G00000D01  111D111111D1111111111111111111111111111111    11011
1000000D01  1000001 1101100000000001000000000000000001   1100011
1111111101  1001001 11D1101111111101001100011100011001  1100D0011
       101  1010101 1000101000000101001100011100011001 11001010011
       101  1001001 10001010111101010000000111000000011100100010011
       101  1000001 1000101010010101001100000000011001100100G0010011
       101  1001001 10N01010000101010000000111000000011100100010011
       101  1010101 1000101111110101001100011100011001 11001010011
       101  1001001 1000100000000101001100011100011001  110010011
       101  1000001 1000111111111101000000000000000001   1100011
       101  1110111111D1111111111101111111110111111111111111011
       101  100000D000000000000000G000000000000000000000000001
       101  111111111111111111111111111111111111111111111111D1
       1011110100010001000100010001000100010001000100010001001
       10000D0001000100010001000100010001000100010001000100001
       1111110100010001000100010001000100010001000100010001001
            11111111111111111111111111111111111111111111111111
