NO ./textures/imgs/blue_wall.xpm
SO ./textures/imgs/brick_wall_dark.xpm
WE ./textures/imgs/eye_wall.xpm
EA ./textures/imgs/wooden_wall_dark.xpm

C 10,50,150
F 50,50,50

11111111111111111111111111111
10000000001100000000000000001
10110000011100000000000010001
1001000000D000000000000010001
10110000011100000000000010001
10000000001100000111011110G01
11110111111111011100000010001
1111D111111111011101010010001
11000000110101011100000010001
10000000000000001100000010001
10000000000000001100010000001
11000000110101000000000000001
11110111110101000000000000001
100G0000001100000100000010001
1000000000D000000000000001001
10000000001000010000000001001
10000000001101000000N00000001
10000000000100000001010000001
11111111111111111111111111111