NO ./textures/imgs/blue_wall.xpm
SO ./textures/imgs/brick_wall_dark.xpm
WE ./textures/imgs/eye_wall.xpm
EA ./textures/imgs/wooden_wall_dark.xpm

C 75,0,25
F 5,10,30


11111111111111
10000000000001
10W00000000001
10000000000001
11111111111111
