NO ./textures/imgs/blue_wall.xpm
SO ./textures/imgs/brick_wall_dark.xpm
WE ./textures/imgs/eye_wall.xpm
EA ./textures/imgs/wooden_wall_dark.xpm

C 5,2,50
F 50,50,50


1111111111111111111111111
10000011000G1000000000001
1000G000000010000000G0001
10000E00D000D00G000000001
1000000000001000000000001
100000110000D000000000001
10000G0000001000000000001
1111111111111111111111111
