NO ./texture/L_wall_brick.xpm
SO ./texture/L_wall_brick.xpm
WE ./texture/L_wall_grey.xpm
EA ./texture/L_wall_grey.xpm

C 10,50,150
F 50,50,50


1111111111111111111111111
1000000000001000000000001
1000000000001000000000001
10000E000000D000000000001
1000000000001000000000001
1000000000001000000000001
1111111111111111111111111