SO ./path_to_the_south_texture
NO ./path_to_the_north_texture




EA ./path_to_the_east_texture
WE ./path_to_the_west_texture

F 220,100,0
C 225,100,0


111111111111 111111111111
1000000000001000000000001
1000000000000000000000001
1000000000000000000000001
1000000000000000000000011
1000000000000000000000001
1111111111111111111111111