NO ./texture/bluestone.xpm
SO ./texture/purplestone.xpm
WE ./texture/wall_1.xpm

F 255, 255, 255
C 255, 255, 200

111111
100001111
10W001111
100000001
111011111
  101
  111