NO ./textures/imgs/blue_wall.xpm
SO ./textures/imgs/brick_wall_dark.xpm
WE ./textures/imgs/eye_wall.xpm
EA ./textures/imgs/wooden_wall_dark.xpm
F 220,100,0
C 225,30,0
        1111111111111111111111111
        1000000000110000000000001
        1011000001110000000000001
        1001000000000000000N00001
111111111011000001110000000000001
100000000011000001110111111111101
11110111111111011100000010001
11110111111111011101010010001
1100000111111111111110001000111
10000001          0000000010001
10000001          1111010010001
11000001 1111111111101111000111
11110111 1110101 101111010001
11111111 1111111 111111111111