NO ./textures/imgs/blue_wall.xpm
SO ./textures/imgs/brick_wall_dark.xpm
WE ./textures/imgs/eye_wall.xpm
EA ./textures/imgs/wooden_wall_dark.xpm

C 5,2,50
F 50,50,50


1111111111111111111111111
1000001100001000000000001
1000000000001000000000001
10000E000000D00G000000001
1000000000001000000000001
1000001100001000000000001
1000000000001000000000001
1111111111111111111111111
