NO texture/brick.xpm
SO texture/brick.xpm
WE texture/brick.xpm
EA texture/brick.xpm

F 255, 255, 255
C 255, 255, 200

111111111
100000001
10W000001
100000001
111111111
