NO texture/brick.xpm
SO texture/brick.xpm
WE texture/brick.xpm
EA texture/brick.xpm
         
F 0,0,0
C 255,255,255
        
111111
100001111
10W001111
100000001
111011111
  101
  111
      
111011
100001111
100001111
100000001
111011111
  101
  111







