NO ./textures/blue_wall.xpm
SO ./textures/imgs/brick_wall_dark.xpm
WE ./textures/imgs/eye_wall.xpm
EA ./textures/imgs/wooden_wall_dark.xpm
         
F 0,0,0
C 255,255,255
        
111111
100001111
10000111111111111111111111111111111111
1N000000000000000000000000000000000001
11101111111111111111111111111111111111
  101
  1011111111111111111111111111111111111
  1000000000000000000000000000000000001
  1111111111111111111111111111111111111
      
111011
100001111
100001111
100000001
111011111
  101
  111







