NO ./textures/imgs/blue_wall.xpm
SO ./textures/imgs/brick_wall_dark.xpm
WE ./textures/imgs/eye_wall.xpm




F    0,0,0
C    255,255,255

111111
100001111
10W001111
100000001
111011111
  101
  111