NO texture/brick.xpm
SO texture/brick.xpm
WE texture/brick.xpm
EA texture/brick.xpm

F 255, 255, 255
C 255, 255, 255

111111
100001111
10W 01111
100000001
111011111
  101
  111